0 0 0 0 0 0 0 0 0 0 0 0 0 0 0 0 0 0 0 0 0 0 0 0 0 0 0 0 0 0 0 0 0 0 0 0 0 0 0 0 0 0 0 0 0 0 0 0 0 0 0 0 0 0 0 0 0 0 0 0 0 0 0 0 0 0 0 0 0 0 0 0 0 0 0 0 0 0 0 0 0 0 0 0 0 0 0 0 0 0 0 0 0 0 0 0 0 0 0 0 0 0 0 0 0 0 0 0 0 0 0 0 0 0 0 0 0 0 0 0 0 0 0 0 0 0 35 36 37 38 0 0 0 0 0 0 0 0 0 0 0 0 0 0 0 0 0 0 0 0 0 0 0 0 0 0 0 0 0 0 0 0 0 0 0 0 0 0 0 0 0 0 0 0 0 0 0 0 0 0 0 0 0 0 0 0 0 0 0 0 0 0 0 0 0 0 0 0 0 0 0 0 0 0 0 0 0 0 0 0 0 0 0 0 0 0 0 0 0 0 0 0 0 0 0 0 0 0 0 0 0 0 0 0 0 0 0 0 0 0 0 0 0 0 0 0 0 0 0 0 0 0 0 0 0 0 0 0 0 0 0 0 0 0 0 0 0 0 0 0 0 0 0 0 0 0 0 0 0 0 0 0 0 0 0 0 0 0 0 0 0 0 0 0 0 0 0 0 0 0 0 0 0 0 0 0 0 0 0 0 0 0 0 0 0 0 0 0 0 0 0 0 0 0 0 0 0 0 0 0 0 0 0 0 0 0 0 0 0 0 0 0 0 0 0 0 0 0 0 0 0 0 0 0 0 0 0 0 0 0 0 0 0 0 0 0 0 0 0 0 0 0 0 0 0 0 0 0 0 0 0 0 0 0 0 0 0 0 0 0 0 0 0 0 0 0 0 0 0 0 
0 0 0 0 0 0 0 0 0 0 0 0 0 0 0 0 0 0 0 0 0 0 0 0 0 0 0 0 0 0 0 0 0 0 0 0 0 0 0 0 0 0 0 0 0 0 0 0 0 0 0 0 0 0 0 0 0 0 0 0 0 0 0 0 0 0 0 0 0 0 0 0 0 0 0 0 0 0 0 0 0 0 0 0 0 0 0 0 0 0 0 0 0 0 0 0 0 0 0 0 0 0 0 0 0 0 0 0 0 0 0 0 0 0 0 0 0 0 0 0 0 0 0 0 0 0 64 65 66 67 0 0 0 0 0 0 0 0 0 0 0 0 0 0 0 0 0 0 0 0 0 0 0 0 0 0 0 0 0 0 0 0 0 0 0 0 0 0 0 0 0 0 0 0 0 0 0 0 0 0 0 0 0 0 0 0 0 0 0 0 0 0 0 0 0 0 0 0 0 0 0 0 0 0 0 0 0 0 0 0 0 0 0 0 0 0 0 0 0 0 0 0 0 0 0 0 0 0 0 0 0 0 0 0 0 0 0 0 0 0 0 0 0 0 0 0 0 0 0 0 0 0 0 0 0 0 0 0 0 0 0 0 0 0 0 0 0 0 0 0 0 0 0 0 0 0 0 0 0 0 0 0 0 0 0 290 290 290 290 0 0 0 0 0 0 0 0 0 0 0 0 0 0 0 0 0 0 0 0 0 0 0 0 0 0 0 0 0 0 0 0 0 0 0 0 0 0 0 0 0 0 0 0 0 0 0 0 0 0 0 0 0 0 0 0 0 0 0 0 0 0 0 0 0 0 0 0 0 0 0 0 0 0 0 0 0 0 0 0 0 0 0 0 0 0 0 0 0 0 0 0 0 0 0 0 0 0 0 0 0 0 0 0 0 0 0 0 0 0 0 
0 0 0 0 1 2 3 4 0 290 290 290 290 0 0 0 0 0 0 0 0 0 0 0 0 0 0 0 0 0 0 0 0 0 0 0 0 0 0 0 0 0 0 0 0 0 0 0 0 0 0 0 0 0 0 0 0 0 0 0 0 0 0 0 0 0 0 0 0 0 0 0 0 0 0 0 0 0 0 0 0 0 0 0 0 0 0 0 0 0 0 0 0 0 0 0 0 0 290 290 290 290 0 0 0 0 0 0 0 0 0 35 36 37 38 0 0 0 0 0 0 0 0 0 0 0 93 94 95 96 0 0 0 0 0 0 0 0 0 0 0 0 0 0 0 0 0 0 0 0 0 0 0 0 0 0 0 0 0 0 0 0 0 0 0 0 0 0 0 0 0 0 0 0 0 0 0 0 0 0 0 0 0 0 0 0 0 0 0 0 0 0 0 0 0 0 0 0 0 0 0 0 0 0 0 0 0 0 0 0 0 0 0 0 0 0 0 0 0 0 0 0 0 0 0 0 0 0 0 0 0 0 0 0 0 0 0 0 0 0 0 0 0 0 0 0 0 0 35 36 37 38 0 0 0 0 0 0 0 0 0 0 0 0 0 0 0 0 0 0 0 0 0 0 0 0 0 0 0 0 0 0 0 0 0 0 0 0 0 0 0 0 0 0 0 0 0 0 0 0 0 0 0 0 0 0 0 0 0 0 0 0 0 0 0 0 0 0 0 0 0 0 0 0 0 0 0 0 0 0 0 0 0 0 0 0 0 0 0 0 0 0 0 0 0 0 0 0 0 0 0 0 0 0 0 0 0 0 0 0 0 0 0 0 0 0 0 0 0 0 0 0 0 0 0 0 0 0 0 0 0 0 0 0 0 0 0 0 0 0 0 0 0 0 0 0 0 0 0 0 
0 0 0 0 30 31 32 33 0 0 0 0 0 0 0 0 0 0 0 0 0 0 0 0 0 0 0 0 0 0 0 0 0 0 0 0 0 0 0 0 0 0 0 0 0 0 0 0 0 0 0 0 0 0 0 0 0 0 0 0 0 0 0 0 0 0 0 0 0 0 0 0 0 0 0 0 0 0 0 0 0 0 0 0 0 37 38 0 0 0 0 0 0 0 0 0 0 0 0 0 0 0 0 0 0 0 0 0 0 0 0 64 65 66 67 0 0 0 0 0 0 146 147 148 147 151 147 147 124 147 151 151 151 151 148 161 161 147 147 147 147 0 0 0 0 0 0 0 0 0 0 37 38 0 0 0 0 0 0 0 0 0 290 290 290 290 0 0 0 0 0 154 147 148 147 148 147 147 148 0 0 0 0 0 0 0 0 0 0 0 0 0 290 290 290 290 0 0 0 0 0 0 0 0 0 0 0 0 0 0 0 0 0 0 0 0 0 0 0 0 0 0 0 0 0 0 0 0 0 0 0 76 77 78 0 0 0 0 0 0 0 0 0 0 0 0 0 0 64 65 66 67 0 0 0 0 0 0 0 0 0 0 0 0 0 0 0 0 0 0 0 0 0 0 0 0 0 0 1 2 3 4 0 0 0 0 0 0 0 0 0 0 0 0 0 0 0 0 0 0 0 0 0 0 0 0 0 0 0 0 0 0 0 0 0 0 0 0 0 0 0 0 35 36 37 38 0 0 0 0 0 0 0 0 0 0 0 0 0 0 0 0 0 0 0 0 0 0 0 0 0 0 0 0 0 0 0 0 0 0 0 0 0 0 0 0 0 0 0 0 0 0 0 0 0 0 0 0 0 0 0 0 0 0 0 0 0 0 0 0 0 0 0 0 0 0 0 0 0 0 
0 0 0 0 59 60 61 62 0 0 0 0 0 0 0 0 146 147 0 0 0 0 0 0 0 0 35 36 37 38 0 0 0 0 0 0 0 0 0 0 0 0 0 0 0 0 0 290 290 290 290 0 0 0 0 0 0 0 0 0 0 0 0 0 0 0 0 0 0 0 0 0 0 0 0 0 0 0 0 0 0 0 0 64 65 66 67 0 0 0 0 0 0 0 1 2 3 4 0 0 0 0 0 0 0 0 0 0 0 0 0 93 94 95 1 147 147 147 0 0 0 175 176 176 176 176 176 176 176 176 176 176 176 176 176 176 176 176 176 176 190 191 0 0 0 0 0 0 0 64 65 66 67 0 0 0 1 2 3 4 0 0 0 0 0 0 0 0 0 0 0 178 180 180 180 180 180 180 180 67 153 153 153 153 153 153 0 0 0 0 0 0 0 0 0 0 0 0 0 0 0 0 0 0 0 0 0 0 0 0 0 0 0 0 0 0 0 0 0 0 0 0 0 0 0 0 0 0 76 77 78 0 0 290 290 290 290 0 0 0 0 0 0 0 0 0 0 0 93 94 95 96 0 0 0 0 0 0 0 0 0 1 2 3 4 0 0 0 0 0 0 0 0 0 0 0 0 0 30 31 32 33 0 0 0 0 0 0 0 0 0 0 0 0 0 0 0 0 0 0 0 0 0 0 0 0 0 0 0 0 0 0 0 0 0 0 0 0 0 0 0 0 64 65 66 67 0 0 0 0 0 0 0 0 0 0 0 0 0 290 290 290 290 290 290 290 290 0 0 0 0 0 0 0 0 0 0 0 0 0 0 0 0 0 0 0 0 0 0 0 0 0 0 0 0 0 0 0 0 0 0 0 0 0 0 0 0 0 0 0 0 0 0 0 0 0 0 0 0 0 
0 0 0 0 0 0 0 0 0 0 0 0 0 0 0 175 176 177 191 0 0 0 0 0 0 0 64 65 66 67 0 290 290 290 290 0 0 0 0 0 1 2 3 4 0 0 0 0 0 0 0 0 35 36 37 38 0 0 0 0 0 0 0 0 0 0 0 0 0 0 0 0 0 290 290 290 290 0 0 0 0 0 0 93 94 95 96 0 0 0 0 0 0 0 30 31 32 33 0 0 0 0 0 0 0 0 0 0 147 147 147 147 147 124 175 176 176 176 220 0 0 0 127 127 127 0 127 127 127 127 0 127 127 127 127 127 127 0 127 127 127 0 0 0 0 0 0 0 0 93 94 95 96 0 0 0 30 31 32 33 0 0 0 0 0 0 0 0 0 0 192 204 205 205 205 205 205 205 205 176 176 176 176 176 176 177 253 0 0 0 0 0 0 0 0 0 0 0 35 36 37 38 0 0 0 0 0 0 0 0 0 0 0 0 0 0 0 0 0 0 0 0 76 77 78 0 0 0 0 0 0 0 0 0 0 74 75 0 0 0 0 0 0 0 0 147 147 147 147 147 124 147 0 0 0 0 0 0 0 0 0 30 31 32 33 0 0 0 0 0 0 0 0 0 0 0 0 0 59 60 61 62 0 0 0 0 0 0 0 0 0 0 0 0 0 0 0 0 0 0 0 0 0 0 0 0 0 0 0 0 0 0 0 0 0 0 0 0 0 0 0 0 93 94 95 96 147 147 147 0 0 0 0 0 0 0 0 0 0 0 0 0 0 0 0 0 0 0 0 0 0 0 0 197 198 0 0 199 200 0 0 0 0 0 0 0 0 0 0 0 0 0 0 0 0 0 0 0 0 0 0 0 0 0 0 0 0 0 0 0 0 0 0 0 0 0 0 0 0 0 
146 147 148 291 151 151 151 151 151 151 151 151 151 148 147 204 205 206 191 0 0 0 0 0 0 0 93 94 95 96 0 0 0 0 0 0 0 0 0 0 30 31 32 33 0 0 0 0 0 0 0 0 64 65 66 67 0 0 0 146 147 148 147 147 147 148 147 147 147 147 151 0 0 0 0 0 0 0 146 147 147 147 147 147 147 124 147 0 0 0 0 0 0 0 59 60 61 62 0 0 0 0 0 0 0 0 175 176 176 176 176 176 176 176 180 205 234 234 191 0 0 0 0 0 0 0 0 0 0 0 0 0 0 0 0 0 0 0 0 0 0 0 0 1 2 3 4 0 0 0 147 124 147 147 3 0 59 60 61 62 0 0 0 0 0 0 0 0 0 0 233 234 234 234 234 234 234 234 205 205 205 182 182 176 176 176 176 176 176 176 253 0 0 0 0 0 0 0 64 65 66 67 0 0 0 0 0 0 0 0 0 0 0 0 0 0 0 0 0 76 77 78 0 0 0 0 0 0 0 0 0 0 0 0 0 0 0 0 0 0 0 0 147 147 147 176 176 176 176 176 176 176 0 0 0 0 0 0 0 0 0 59 60 61 62 0 146 147 147 147 147 147 147 147 147 0 0 0 0 0 0 0 0 0 0 0 37 38 0 0 0 0 0 0 0 0 0 0 147 147 147 147 147 147 147 0 0 0 0 0 0 0 0 0 0 0 147 147 147 147 147 147 147 123 124 175 176 176 176 220 0 0 0 0 0 0 0 0 0 0 0 0 0 0 0 0 0 0 0 0 0 0 0 226 227 0 0 228 229 0 0 0 0 157 157 157 157 157 157 157 0 0 0 0 0 0 0 0 0 0 0 0 0 0 0 0 0 0 0 0 0 0 0 0 0 0 0 0 0 0 
175 176 176 176 176 176 176 176 176 176 176 176 176 176 176 176 234 235 191 0 0 146 147 148 147 151 147 147 124 147 151 151 148 161 161 147 147 147 147 0 59 60 61 62 0 0 0 0 0 0 0 0 93 94 95 96 0 0 0 175 176 176 176 176 176 176 176 176 176 176 176 0 0 0 0 0 0 0 175 176 176 176 176 176 176 176 176 105 147 147 147 0 0 0 0 0 0 0 0 0 1 2 3 4 0 0 68 69 69 69 69 69 234 234 234 234 234 234 220 0 0 0 0 290 290 290 290 0 0 0 0 0 1 2 3 4 0 0 0 0 0 0 0 30 31 32 33 0 0 68 31 176 176 176 32 73 0 0 0 0 0 198 0 0 0 199 0 0 0 0 0 0 127 127 0 0 127 127 127 0 127 127 127 0 127 127 127 0 127 127 0 0 0 0 0 0 0 0 93 94 95 96 0 0 0 0 0 151 151 151 151 148 161 161 147 147 147 147 0 0 0 0 0 0 0 0 0 198 0 0 0 199 0 0 0 0 0 0 0 0 117 176 176 176 176 205 205 205 205 205 205 176 220 147 147 147 147 147 147 0 0 0 0 0 0 0 175 176 176 176 176 176 176 176 176 191 147 147 147 0 0 0 0 0 64 65 66 67 0 0 0 0 0 147 147 147 147 147 176 176 176 176 176 176 176 220 0 0 1 2 3 4 0 0 175 176 176 176 176 176 176 176 176 176 176 180 180 234 234 191 0 0 0 0 0 76 77 78 0 0 0 0 0 0 0 0 139 140 0 142 143 0 0 255 256 0 0 257 258 0 131 0 0 111 72 72 72 72 72 72 0 0 0 0 0 0 0 0 0 0 0 0 0 0 0 0 0 0 0 0 0 0 0 0 0 0 0 0 0 0 
204 205 205 205 205 205 205 205 205 205 205 205 205 205 205 205 205 205 220 0 0 175 176 176 176 176 176 176 176 176 176 176 176 176 176 176 176 176 190 191 0 0 0 146 147 148 147 147 147 148 147 147 147 147 124 151 147 0 0 233 205 205 205 205 205 205 205 205 205 205 205 0 0 0 0 117 118 0 204 205 205 205 205 205 205 205 176 176 176 176 176 291 147 147 147 147 147 147 0 0 30 31 32 33 0 0 0 127 127 127 0 127 0 127 0 130 130 0 0 1 2 3 3 0 0 0 1 2 3 4 0 0 30 31 32 33 0 1 2 3 4 0 0 59 60 61 62 0 0 97 98 98 98 72 101 102 0 0 0 0 0 227 0 0 0 228 0 0 0 0 0 0 0 0 0 0 0 1 2 3 4 0 0 0 0 0 0 0 0 0 0 0 0 146 147 148 147 151 147 147 124 147 0 0 0 0 0 176 176 176 176 176 176 176 176 176 176 190 191 0 0 0 0 0 0 0 0 227 0 0 0 228 0 0 0 0 0 0 0 0 250 205 205 205 205 234 234 234 234 234 234 205 176 176 176 176 176 176 176 220 0 0 0 0 0 0 204 205 205 205 205 205 205 205 176 176 176 176 176 220 147 147 147 147 93 94 95 96 0 146 147 147 147 176 176 176 176 176 176 176 176 176 220 0 0 0 0 0 30 31 32 33 0 0 68 69 69 69 69 69 69 69 69 234 234 234 234 234 234 220 0 0 76 77 78 0 0 0 0 142 143 0 139 140 0 0 168 169 0 171 172 0 0 284 285 0 0 286 287 0 0 0 0 111 72 72 72 72 72 101 0 0 0 0 0 0 0 0 0 0 0 0 0 0 0 0 0 0 0 0 0 0 0 0 0 0 0 0 0 0 
239 267 267 267 267 267 267 267 267 267 267 267 267 267 267 267 267 267 249 0 0 236 267 267 267 267 267 267 267 267 267 267 267 267 267 267 267 267 267 249 0 0 0 175 176 176 176 176 176 176 176 176 176 176 176 190 190 191 0 0 0 0 0 0 88 89 0 0 0 0 0 0 117 118 0 0 0 0 233 234 234 234 234 234 234 234 205 205 205 205 205 176 176 176 176 176 176 176 220 0 59 60 61 62 0 0 0 0 0 0 0 0 0 0 0 0 0 0 0 30 31 32 32 0 0 0 30 31 32 33 0 0 59 60 61 62 0 30 31 32 33 0 0 0 0 0 0 0 0 126 127 127 127 127 130 131 0 0 0 0 0 256 0 0 0 257 0 0 111 80 80 80 80 80 80 0 0 30 31 32 33 0 0 0 0 104 105 0 0 0 0 0 0 175 176 176 176 176 176 176 176 176 67 0 0 0 0 0 0 0 0 0 0 0 0 0 0 0 0 0 0 0 0 0 0 0 0 256 0 0 0 257 0 0 0 0 0 0 0 0 0 0 0 0 0 0 0 0 0 0 0 0 0 0 0 0 0 0 0 0 0 0 0 0 0 0 233 234 234 234 234 234 234 234 205 205 205 205 205 176 176 176 176 176 176 176 124 0 0 175 176 176 176 176 176 176 176 176 176 176 220 0 0 0 0 0 0 0 59 60 61 62 0 0 0 267 267 267 267 267 267 267 267 267 267 267 267 267 267 0 0 0 0 0 0 0 0 0 0 171 172 0 168 169 0 0 0 0 0 0 0 0 0 0 0 0 0 0 0 0 0 0 0 102 0 0 0 0 0 0 0 0 0 0 0 0 0 0 0 0 0 0 0 0 0 0 0 0 0 0 0 0 0 0 0 0 0 0 0 0